############
#..........#
#.@........#
#..........#
#.########.#
#..........#
#..........#
#....X.....#
#..........#
#..........#
############